XXXXXXXXXXXXXXXXXXXXX12322XXXXXX222XXXXXXXX
1d232231213123123123213c131312XXXX211231231
XXXXXXXX231231231232223123123XXXXXXX2123XXX
XXXXXXXXXXXXXXXX1231231231231221XXXXXXXXXXX
XXXXXXXXXXXXXXXXXXX12312321XXXXXXXXXXXXXXXX
XXXXXXXXXXXXXXXXXXXXXXX2XXXXXXXXXXXXXXXXXXX
XXXXXXXXXXXXXXXXXX2322322123XXXXXXXXXXXXXXX
XXXXXXXXXXXXXX123123a3232312312321XXXXXXXXX
XXXXXXXXXX313123123231123123123b232211XXXXX
XXXX123213131232112312321XXXX3212312312312X
XXXXXXXXXXXXXXXXXXXXXXXXXXXXXXXXXXX1122312X